Tileset [
    name=TreasureHunters,
    texturePath=resources/TerrainAtlas.png,
    tileWidth=32,
    tileHeight=32,
    width=544,
    height=160,
],
Level [
    size=36,20,
    tiles=19,19,19,19,19,19,19,19,19,19,19,19,19,19,19,19,19,19,19,19,19,19,19,19,19,19,19,19,19,19,19,19,19,19,19,19,
19,19,19,19,19,19,19,19,19,19,19,19,19,19,19,19,19,19,19,19,19,19,19,19,19,19,19,19,19,19,19,19,19,19,19,19,
19,19,19,19,19,19,19,19,19,19,19,7,36,36,8,7,36,36,8,19,19,19,19,19,19,19,19,19,19,19,19,19,19,19,19,19,
19,19,19,19,19,19,19,19,7,36,36,37,0,0,18,20,0,0,35,8,19,19,19,19,19,19,19,19,19,19,19,19,19,19,19,19,
19,19,19,19,19,19,19,19,20,0,0,0,0,0,35,37,0,0,0,18,19,19,19,19,19,19,19,19,19,19,19,19,19,19,19,19,
19,19,19,19,19,19,19,19,20,0,0,0,0,0,0,0,0,0,0,35,36,36,36,36,36,8,19,19,19,19,19,19,19,19,19,19,
19,19,19,19,19,19,19,7,37,0,0,0,0,0,0,0,0,0,0,0,0,0,0,0,0,35,8,19,19,19,19,19,19,19,19,19,
19,19,19,19,19,19,19,20,0,0,0,0,0,0,0,0,0,0,0,0,0,0,0,0,0,0,18,19,19,19,19,19,19,19,19,19,
19,19,19,19,19,19,7,37,0,0,0,0,0,0,0,0,0,0,0,0,0,5,0,0,0,0,18,19,19,19,19,19,19,19,19,19,
19,19,19,19,19,19,20,0,0,0,0,0,0,0,0,0,0,0,0,0,0,22,0,0,0,0,18,19,19,19,19,19,19,19,19,19,
19,19,19,19,19,19,20,0,0,0,0,0,0,0,0,0,0,0,1,2,2,2,3,0,0,0,18,19,7,36,8,19,19,19,19,19,
19,19,19,7,36,36,37,0,0,0,0,0,0,1,2,3,0,0,18,19,19,19,20,0,0,0,18,19,20,0,35,36,8,19,19,19,
19,19,19,20,0,0,0,0,0,0,0,0,0,18,19,20,0,0,18,19,19,19,20,0,0,0,18,19,20,0,0,0,18,19,19,19,
19,19,19,20,0,0,0,0,0,1,2,2,2,25,19,20,0,0,18,19,19,19,20,0,0,0,35,36,37,0,0,0,18,19,19,19,
19,19,19,20,0,0,0,0,0,18,19,19,19,19,19,20,0,0,18,19,19,19,20,0,0,0,0,0,0,0,0,0,18,19,19,19,
19,19,19,20,0,0,0,0,0,18,19,19,19,19,19,20,0,0,18,19,19,19,20,0,0,0,0,0,0,0,0,0,18,19,19,19,
19,19,19,24,2,2,2,2,2,25,19,19,19,19,19,24,2,2,25,19,19,19,24,2,2,2,2,2,2,2,2,2,25,19,19,19,
19,19,19,19,19,19,19,19,19,19,19,19,19,19,19,19,19,19,19,19,19,19,19,19,19,19,19,19,19,19,19,19,19,19,19,19,
19,19,19,19,19,19,19,19,19,19,19,19,19,19,19,19,19,19,19,19,19,19,19,19,19,19,19,19,19,19,19,19,19,19,19,19,
19,19,19,19,19,19,19,19,19,19,19,19,19,19,19,19,19,19,19,19,19,19,19,19,19,19,19,19,19,19,19,19,19,19,19,19
]
Entities [   
  id="5" name="PlayerStart" type="EntitySpawn" x="592" y="315.5">
  id="6" name="CoinBrick" type="EntitySpawn" x="336" y="304"/>
  id="7" name="Spikes" type="EntitySpawn" x="520" y="496"/>
  id="8" name="Exit" type="EntitySpawn" x="1000" y="496"/>
  id="9" name="Spikes" type="EntitySpawn" x="552" y="496"/>
]