Tileset [
    name=TreasureHunters,
    texturePath=resources/TerrainAtlas.png,
    tileWidth=32,
    tileHeight=32,
    width=544,
    height=160,
],
Level [
    size=30,15,
    tiles=19,19,19,19,19,19,19,19,7,36,36,36,36,36,36,8,19,19,19,19,19,19,19,19,19,19,19,19,19,19,
        19,19,19,19,19,7,36,36,37,0,0,0,0,0,0,35,8,19,19,19,19,19,19,19,19,19,19,19,19,19,
        19,19,19,19,19,20,0,0,0,0,0,0,0,0,0,0,18,19,19,19,19,19,19,19,19,19,19,19,19,19,
        19,19,19,19,19,20,0,0,0,0,0,0,0,0,0,0,35,36,36,36,36,36,8,19,19,19,19,19,19,19,
        19,19,19,19,7,37,0,0,0,0,0,0,0,0,0,0,0,0,0,0,0,0,35,8,19,19,19,19,19,19,
        19,19,19,19,20,0,0,0,0,0,0,0,0,0,0,0,0,0,0,0,0,0,0,18,19,19,19,19,19,19,
        19,19,19,7,37,0,0,0,0,0,0,0,0,0,0,0,0,0,5,0,0,0,0,18,19,19,19,19,19,19,
        19,19,19,20,0,0,0,0,0,0,0,0,0,0,0,0,0,0,22,0,0,0,0,18,19,19,19,19,19,19,
        19,19,19,20,0,0,0,0,0,0,0,0,0,0,1,2,2,2,2,3,0,0,0,18,19,7,36,8,19,19,
        7,36,36,37,0,0,0,0,0,0,1,2,3,0,18,19,19,19,19,20,0,0,0,18,19,20,0,35,36,8,
        20,0,0,0,0,0,0,0,0,0,18,19,20,0,18,19,19,19,19,20,0,0,0,18,19,20,0,0,0,18,
        20,0,0,0,0,0,1,2,2,2,25,19,20,0,18,19,19,19,19,20,0,0,0,35,36,37,0,0,0,18,
        20,0,0,0,0,0,18,19,19,19,19,19,20,0,18,19,19,19,19,20,0,0,0,0,0,0,0,0,0,18,
        20,0,0,0,0,0,18,19,19,19,19,19,20,0,18,19,19,19,19,20,0,0,0,0,0,0,0,0,0,18,
        24,2,2,2,2,2,25,19,19,19,19,19,24,2,25,19,19,19,19,24,2,2,2,2,2,2,2,2,2,25,
]